Michael	fantasticlife
Dan	dasbarrett
Julie	julietouring
Anya	bitten_
Ben	benwoodhams
Chris	chrisalcockdev
Aidan	aidan_morgan
Jamie	oddtype
Jianhan	jianhanzhu
Ganesh	gansenthi
Tony	psychemedia
Samu	langsamu
Liz	greensideknits
Silver	silveroliver
EdWhite	ewhitur
Oli	olihawkins
Graham	grahampeek
Matt	mattrayner
Phil	philbgorman
Franny	eff_shaped
Alex alexedwardh
Gavin	GavBerman
Sara	sarafreis
Matthieu	cognithive
James	thevinternet
Alison	oliala
Joe	joe_parl_ds